+-+-+-+-+-+-+-+-+-+-+
  |     |     |     |
+ +-+ + + +-+ +-+-+ +
|   | | |   |     | |
+ + + +-+-+-+-+-+ + +
| |   |             |
+ +-+-+ +-+-+-+-+-+ +
|   |   |     |   | |
+ +-+ +-+ +-+ + + + +
| |   |     |   | | |
+ + +-+ +-+-+-+ +-+ +
| |   | |   | |     |
+ +-+ + + + + +-+-+-+
|     |   |         |
+-+-+ +-+-+-+ +-+-+ +
|   |     | | |   | |
+ + +-+-+ + + + + + +
| |     | | | | | | |
+ +-+-+ + + + +-+ + +
|     |   |       |  
+-+-+-+-+-+-+-+-+-+-+